tournament,team,pts,jj,dg,jg,je,jp,gf,gc
clausura-2018,América,0,0,0,0,0,0,0,0
clausura-2018,Atlas,0,0,0,0,0,0,0,0
clausura-2018,Chivas,0,0,0,0,0,0,0,0
clausura-2018,Club Querétaro,0,0,0,0,0,0,0,0
clausura-2018,Club Tijuana,0,0,0,0,0,0,0,0
clausura-2018,Cruz Azul,0,0,0,0,0,0,0,0
clausura-2018,León,0,0,0,0,0,0,0,0
clausura-2018,Lobos BUAP,0,0,0,0,0,0,0,0
clausura-2018,Monterrey,0,0,0,0,0,0,0,0
clausura-2018,Morelia,0,0,0,0,0,0,0,0
clausura-2018,Necaxa,0,0,0,0,0,0,0,0
clausura-2018,Pachuca,0,0,0,0,0,0,0,0
clausura-2018,Puebla,0,0,0,0,0,0,0,0
clausura-2018,Pumas,0,0,0,0,0,0,0,0
clausura-2018,Santos,0,0,0,0,0,0,0,0
clausura-2018,Tigres,0,0,0,0,0,0,0,0
clausura-2018,Toluca,0,0,0,0,0,0,0,0
clausura-2018,Veracruz,0,0,0,0,0,0,0,0
apertura-2017,Monterrey,37,17,17,11,4,2,29,12
apertura-2017,Tigres,32,17,12,9,5,3,28,16
apertura-2017,América,30,17,5,9,3,5,23,18
apertura-2017,Morelia,29,17,8,8,5,4,25,17
apertura-2017,Toluca,29,17,3,8,5,4,24,21
apertura-2017,Cruz Azul,27,17,0,7,6,4,22,22
apertura-2017,León,26,17,4,8,2,7,27,23
apertura-2017,Atlas,25,17,4,7,4,6,23,19
apertura-2017,Necaxa,24,17,4,6,6,5,19,15
apertura-2017,Lobos BUAP,23,17,-5,7,2,8,26,31
apertura-2017,Club Tijuana,21,17,-6,6,3,8,17,23
apertura-2017,Pachuca,19,17,-2,5,4,8,23,25
apertura-2017,Chivas,18,17,-2,4,6,7,21,23
apertura-2017,Santos,18,17,-3,3,9,5,20,23
apertura-2017,Puebla,16,17,-6,3,7,7,14,20
apertura-2017,Club Querétaro,16,17,-8,3,7,7,19,27
apertura-2017,Veracruz,14,17,-14,4,2,11,14,28
apertura-2017,Pumas,13,17,-11,3,4,10,14,25
clausura-2017,Club Tijuana,31,17,8,9,4,4,30,22
clausura-2017,Monterrey,27,17,8,7,6,4,26,18
clausura-2017,Chivas,27,17,3,7,6,4,21,18
clausura-2017,Toluca,27,17,1,8,3,6,21,20
clausura-2017,Santos,26,17,5,5,11,1,25,20
clausura-2017,Atlas,26,17,4,7,5,5,24,20
clausura-2017,Tigres,25,17,14,7,4,6,26,12
clausura-2017,Morelia,24,17,3,6,6,5,19,16
clausura-2017,América,24,17,0,7,3,7,19,19
clausura-2017,Pachuca,24,17,0,6,6,5,16,16
clausura-2017,Cruz Azul,21,17,-1,5,6,6,19,20
clausura-2017,Necaxa,21,17,-5,5,6,6,16,21
clausura-2017,Veracruz,21,17,-6,7,0,10,14,20
clausura-2017,León,20,17,-2,5,5,7,21,23
clausura-2017,Club Querétaro,19,17,-6,5,4,8,21,27
clausura-2017,Chiapas FC,19,17,-10,5,4,8,18,28
clausura-2017,Pumas,18,17,-9,5,3,9,21,30
clausura-2017,Puebla,16,17,-7,4,4,9,18,25
apertura-2016,Club Tijuana,33,17,12,10,3,4,25,13
apertura-2016,Pachuca,31,17,15,9,4,4,36,21
apertura-2016,Tigres,30,17,9,8,6,3,22,13
apertura-2016,Chivas,28,17,4,8,4,5,21,17
apertura-2016,América,28,17,3,7,7,3,29,26
apertura-2016,Pumas,27,17,6,8,3,6,28,22
apertura-2016,Necaxa,26,17,6,6,8,3,24,18
apertura-2016,León,26,17,0,7,5,5,25,25
apertura-2016,Monterrey,25,17,9,6,7,4,30,21
apertura-2016,Toluca,24,17,1,6,6,5,22,21
apertura-2016,Club Querétaro,20,17,-4,5,5,7,20,24
apertura-2016,Puebla,20,17,-5,5,5,7,25,30
apertura-2016,Morelia,20,17,-6,5,5,7,28,34
apertura-2016,Cruz Azul,19,17,2,4,7,6,25,23
apertura-2016,Atlas,19,17,-4,4,7,6,21,25
apertura-2016,Santos,16,17,-11,4,4,9,19,30
apertura-2016,Veracruz,12,17,-16,3,3,11,22,38
apertura-2016,Chiapas FC,9,17,-21,2,3,12,9,30
clausura-2016,Monterrey,37,17,15,12,1,4,38,23
clausura-2016,Pachuca,30,17,15,8,6,3,31,16
clausura-2016,León,30,17,10,9,3,5,29,19
clausura-2016,América,29,17,12,8,5,4,34,22
clausura-2016,Chivas,28,17,10,7,7,3,26,16
clausura-2016,Morelia,28,17,1,8,4,5,25,24
clausura-2016,Santos,27,17,2,8,3,6,22,20
clausura-2016,Tigres,24,17,10,6,6,5,29,19
clausura-2016,Cruz Azul,22,17,1,5,7,5,25,24
clausura-2016,Pumas,22,17,-1,5,7,5,23,24
clausura-2016,Toluca,22,17,-1,5,7,5,20,21
clausura-2016,Puebla,22,17,-5,5,7,5,21,26
clausura-2016,Club Querétaro,19,17,-5,5,4,8,21,26
clausura-2016,Club Tijuana,18,17,-9,3,9,5,17,26
clausura-2016,Atlas,14,17,-8,3,5,9,18,26
clausura-2016,Dorados,14,17,-14,4,2,11,18,32
clausura-2016,Veracruz,14,17,-16,2,8,7,18,34
clausura-2016,Chiapas FC,12,17,-17,3,3,11,16,33
apertura-2015,Pumas,35,17,17,11,2,4,37,20
apertura-2015,Toluca,32,17,9,10,2,5,33,24
apertura-2015,León,30,17,1,10,0,7,32,31
apertura-2015,Chiapas FC,29,17,4,8,5,4,31,27
apertura-2015,Tigres,28,17,10,8,4,5,26,16
apertura-2015,América,28,17,9,9,1,7,30,21
apertura-2015,Puebla,27,17,2,8,3,6,22,20
apertura-2015,Veracruz,27,17,-4,8,3,6,23,27
apertura-2015,Monterrey,23,17,3,6,5,6,32,29
apertura-2015,Morelia,23,17,0,7,2,8,26,26
apertura-2015,Club Querétaro,22,17,0,6,4,7,25,25
apertura-2015,Pachuca,21,17,-3,6,3,8,30,33
apertura-2015,Chivas,21,17,-3,6,3,8,23,26
apertura-2015,Cruz Azul,20,17,-6,5,5,7,19,25
apertura-2015,Santos,17,17,-3,4,5,8,21,24
apertura-2015,Atlas,17,17,-11,5,2,10,17,28
apertura-2015,Club Tijuana,16,17,-9,5,1,11,21,30
apertura-2015,Dorados,15,17,-16,3,6,8,13,29
clausura-2015,Tigres,29,17,8,9,2,6,23,15
clausura-2015,América,29,17,3,8,5,4,21,18
clausura-2015,Veracruz,28,17,10,7,7,3,28,18
clausura-2015,Atlas,28,17,-1,8,4,5,20,21
clausura-2015,Chivas,26,17,4,7,5,5,20,16
clausura-2015,Club Querétaro,26,17,2,8,2,7,25,23
clausura-2015,Pachuca,25,17,4,7,4,6,25,21
clausura-2015,Santos,25,17,3,7,4,6,24,21
clausura-2015,Cruz Azul,25,17,0,7,4,6,14,14
clausura-2015,Toluca,24,17,2,6,6,5,20,18
clausura-2015,Club Tijuana,24,17,0,7,3,7,30,30
clausura-2015,Monterrey,24,17,-3,7,3,7,24,27
clausura-2015,Pumas,22,17,-5,6,4,7,22,27
clausura-2015,Puebla,20,17,1,5,5,7,21,20
clausura-2015,Chiapas FC,20,17,-9,5,5,7,21,30
clausura-2015,Leones Negros,18,17,-6,5,3,9,13,19
clausura-2015,León,16,17,-5,4,4,9,27,32
clausura-2015,Morelia,13,17,-8,3,4,10,17,25
apertura-2014,América,31,17,10,9,4,4,28,18
apertura-2014,Tigres,31,17,8,8,7,2,25,17
apertura-2014,Atlas,31,17,2,9,4,4,22,20
apertura-2014,Toluca,29,17,6,8,5,4,24,18
apertura-2014,Chiapas FC,28,17,4,7,7,3,24,20
apertura-2014,Monterrey,27,17,3,8,3,6,23,20
apertura-2014,Pachuca,25,17,2,7,4,6,20,18
apertura-2014,Pumas,24,17,4,6,6,5,24,20
apertura-2014,Santos,23,17,-1,5,8,4,23,24
apertura-2014,León,22,17,2,7,1,9,29,27
apertura-2014,Club Tijuana,21,17,2,4,9,4,21,19
apertura-2014,Club Querétaro,21,17,1,6,3,8,23,22
apertura-2014,Cruz Azul,21,17,1,5,6,6,16,15
apertura-2014,Leones Negros,17,17,-6,3,8,6,10,16
apertura-2014,Puebla,16,17,-6,2,10,5,15,21
apertura-2014,Chivas,16,17,-7,3,7,7,13,20
apertura-2014,Veracruz,15,17,-7,3,6,8,8,15
apertura-2014,Morelia,10,17,-18,2,4,11,16,34
clausura-2014,Cruz Azul,36,17,9,11,3,3,28,19
clausura-2014,Toluca,32,17,11,10,2,5,25,14
clausura-2014,Pumas,25,17,6,7,4,6,26,20
clausura-2014,Santos,25,17,4,6,7,4,33,29
clausura-2014,América,25,17,4,7,4,6,21,17
clausura-2014,Pachuca,24,17,2,7,3,7,23,21
clausura-2014,Club Tijuana,24,17,-1,7,3,7,22,23
clausura-2014,León,23,17,6,6,5,6,23,17
clausura-2014,Chiapas FC,23,17,0,6,5,6,23,23
clausura-2014,Monterrey,23,17,0,6,5,6,20,20
clausura-2014,Morelia,21,17,1,5,6,6,21,20
clausura-2014,Atlas,21,17,-1,5,6,6,17,18
clausura-2014,Club Querétaro,21,17,-4,6,3,8,18,22
clausura-2014,Tigres,21,17,-4,5,6,6,13,17
clausura-2014,Chivas,21,17,-5,5,6,6,13,18
clausura-2014,Puebla,18,17,-5,4,6,7,14,19
clausura-2014,Atlante,18,17,-12,5,3,9,22,34
clausura-2014,Veracruz,16,17,-11,3,7,7,14,25
apertura-2013,América,37,17,19,11,4,2,31,12
apertura-2013,Santos,33,17,12,9,6,2,32,20
apertura-2013,León,30,17,11,8,6,3,25,14
apertura-2013,Cruz Azul,29,17,4,8,5,4,21,17
apertura-2013,Toluca,27,17,16,6,9,2,33,17
apertura-2013,Morelia,27,17,3,8,3,6,26,23
apertura-2013,Club Querétaro,26,17,1,7,5,5,20,19
apertura-2013,Tigres,25,17,3,6,7,4,23,20
apertura-2013,Chiapas FC,25,17,1,6,7,4,26,25
apertura-2013,Club Tijuana,21,17,-3,5,6,6,20,23
apertura-2013,Monterrey,20,17,-1,5,5,7,22,23
apertura-2013,Veracruz,20,17,-4,4,8,5,20,24
apertura-2013,Puebla,19,17,-2,4,7,6,19,21
apertura-2013,Pachuca,17,17,-4,3,8,6,14,18
apertura-2013,Atlas,12,17,-11,1,9,7,18,29
apertura-2013,Chivas,12,17,-14,2,6,9,16,30
apertura-2013,Atlante,12,17,-18,3,3,11,17,35
apertura-2013,Pumas,11,17,-13,1,8,8,8,21
clausura-2013,Tigres,35,17,16,10,5,2,30,14
clausura-2013,América,32,17,15,9,5,3,30,15
clausura-2013,Atlas,32,17,7,9,5,3,20,13
clausura-2013,Morelia,30,17,7,8,6,3,25,18
clausura-2013,Cruz Azul,29,17,15,8,5,4,35,20
clausura-2013,Santos,29,17,7,8,5,4,20,13
clausura-2013,Pumas,29,17,5,8,5,4,19,14
clausura-2013,Gallos Blancos,24,17,-2,6,6,5,18,20
clausura-2013,Monterrey,23,17,0,7,2,8,22,22
clausura-2013,Club Tijuana,21,17,-2,6,3,8,19,21
clausura-2013,Pachuca,20,17,-7,6,2,9,18,25
clausura-2013,Puebla,19,17,-7,5,4,8,20,27
clausura-2013,Toluca,18,17,-7,5,3,9,14,21
clausura-2013,Club Querétaro,17,17,-11,4,5,8,21,32
clausura-2013,León,16,17,-4,3,7,7,14,18
clausura-2013,Chiapas FC,16,17,-6,4,4,9,19,25
clausura-2013,Chivas,16,17,-9,3,7,7,15,24
clausura-2013,Atlante,13,17,-17,4,1,12,16,33
apertura-2012,Toluca,34,17,11,10,4,3,28,17
apertura-2012,Club Tijuana,34,17,8,9,7,1,23,15
apertura-2012,León,33,17,17,10,3,4,34,17
apertura-2012,América,31,17,13,8,7,2,28,15
apertura-2012,Morelia,27,17,9,6,9,2,25,16
apertura-2012,Cruz Azul,26,17,7,6,8,3,22,15
apertura-2012,Monterrey,23,17,0,5,8,4,23,23
apertura-2012,Chivas,23,17,0,6,5,6,17,17
apertura-2012,Santos,23,17,-4,6,5,6,22,26
apertura-2012,Pumas,23,17,-5,7,2,8,18,23
apertura-2012,Club Querétaro,22,17,-1,6,4,7,23,24
apertura-2012,Tigres,21,17,5,5,6,6,23,18
apertura-2012,Pachuca,21,17,-7,5,6,6,13,20
apertura-2012,Atlante,20,17,-5,5,5,7,23,28
apertura-2012,Chiapas FC,15,17,-10,3,6,8,14,24
apertura-2012,Puebla,13,17,-11,3,4,10,16,27
apertura-2012,Atlas,12,17,-8,1,9,7,16,24
apertura-2012,Gallos Blancos,7,17,-19,1,4,12,11,30
clausura-2012,Santos,36,17,15,11,3,3,33,18
clausura-2012,Monterrey,32,17,17,9,5,3,32,15
clausura-2012,América,32,17,12,9,5,3,30,18
clausura-2012,Morelia,31,17,7,9,4,4,25,18
clausura-2012,Tigres,31,17,6,9,4,4,22,16
clausura-2012,Pachuca,28,17,7,7,7,3,24,17
clausura-2012,Club Tijuana,28,17,7,7,7,3,18,11
clausura-2012,Club Querétaro,27,17,6,8,3,6,26,20
clausura-2012,Cruz Azul,25,17,8,6,7,4,29,21
clausura-2012,Toluca,22,17,-3,6,4,7,24,27
clausura-2012,Atlas,20,17,-6,4,8,5,7,13
clausura-2012,Puebla,19,17,-4,5,4,8,19,23
clausura-2012,Pumas,16,17,-5,3,7,7,13,18
clausura-2012,Atlante,16,17,-11,4,4,9,20,31
clausura-2012,Chivas,15,17,-9,4,3,10,12,21
clausura-2012,Chiapas FC,12,17,-15,3,3,11,15,30
clausura-2012,Gallos Blancos,12,17,-16,2,6,9,14,30
clausura-2012,Estudiantes,12,17,-16,2,6,9,12,28
apertura-2011,Chivas,30,17,6,8,6,3,24,18
apertura-2011,Cruz Azul,29,17,7,8,5,4,21,14
apertura-2011,Tigres,28,17,9,7,7,3,22,13
apertura-2011,Santos,27,17,4,8,3,6,29,25
apertura-2011,Club Querétaro,26,17,5,7,5,5,28,23
apertura-2011,Pachuca,26,17,3,7,5,5,28,25
apertura-2011,Morelia,26,17,3,7,5,5,25,22
apertura-2011,Gallos Blancos,26,17,3,8,2,7,24,21
apertura-2011,Pumas,25,17,-6,7,4,6,19,25
apertura-2011,Chiapas FC,24,17,3,6,6,5,23,20
apertura-2011,Monterrey,24,17,1,7,3,7,27,26
apertura-2011,Puebla,22,17,-3,6,4,7,26,29
apertura-2011,Toluca,20,17,-8,4,8,5,19,27
apertura-2011,Atlante,19,17,-4,5,4,8,24,28
apertura-2011,Club Tijuana,18,17,-2,3,9,5,21,23
apertura-2011,Estudiantes,18,17,-6,6,0,11,24,30
apertura-2011,América,15,17,-5,3,6,8,26,31
apertura-2011,Atlas,12,17,-10,2,6,9,20,30
clausura-2011,Tigres,35,17,17,10,5,2,26,9
clausura-2011,Monterrey,26,17,3,7,5,5,23,20
clausura-2011,Chivas,25,17,8,6,7,4,23,15
clausura-2011,Santos,23,17,0,7,2,8,23,23
clausura-2011,Estudiantes,17,17,-13,4,5,8,21,34
clausura-2011,Necaxa,15,17,-5,3,6,8,10,15
clausura-2011,Atlante,27,17,11,8,3,6,28,17
clausura-2011,América,26,17,3,8,2,7,31,28
clausura-2011,Atlas,23,17,0,6,5,6,19,19
clausura-2011,Chiapas FC,21,17,2,4,9,4,20,18
clausura-2011,Toluca,21,17,1,5,6,6,28,27
clausura-2011,Pachuca,18,17,-9,4,6,7,16,25
clausura-2011,Pumas,35,17,14,10,5,2,27,13
clausura-2011,Morelia,31,17,7,9,4,4,31,24
clausura-2011,Cruz Azul,26,17,5,7,5,5,25,20
clausura-2011,Puebla,18,17,-10,5,3,9,16,26
clausura-2011,Gallos Blancos,16,17,-19,4,4,9,16,35
clausura-2011,Club Querétaro,14,17,-15,4,2,11,15,30
apertura-2010,Monterrey,32,17,9,9,5,3,29,20
apertura-2010,Santos,30,17,9,9,3,5,28,19
apertura-2010,Tigres,24,17,8,6,6,5,24,16
apertura-2010,Chivas,22,17,1,4,10,3,16,15
apertura-2010,Necaxa,16,17,-7,4,4,9,14,21
apertura-2010,Estudiantes,15,17,-18,4,3,10,18,36
apertura-2010,América,27,17,6,7,6,4,22,16
apertura-2010,Chiapas FC,26,17,2,8,2,7,21,19
apertura-2010,Pachuca,25,17,-1,7,4,6,27,28
apertura-2010,Toluca,22,17,-2,5,7,5,18,20
apertura-2010,Atlante,16,17,-10,4,4,9,17,27
apertura-2010,Atlas,13,17,-9,3,4,10,18,27
apertura-2010,Cruz Azul,39,17,20,12,3,2,33,13
apertura-2010,Club Querétaro,25,17,7,6,7,4,21,14
apertura-2010,Pumas,25,17,-1,7,4,6,23,24
apertura-2010,Morelia,21,17,1,5,6,6,17,16
apertura-2010,Puebla,19,17,-5,5,4,8,21,26
apertura-2010,Gallos Blancos,19,17,-10,5,4,8,18,28
bicentenario-2010,Chivas,32,17,7,10,2,5,28,21
bicentenario-2010,Toluca,30,17,12,8,6,3,27,15
bicentenario-2010,Atlas,24,17,3,7,3,7,26,23
bicentenario-2010,Gallos Blancos,21,17,-12,6,3,8,13,25
bicentenario-2010,Indios,15,17,-19,4,3,10,10,29
bicentenario-2010,Chiapas FC,14,17,-11,3,5,9,18,29
bicentenario-2010,Monterrey,36,17,15,10,6,1,30,15
bicentenario-2010,América,25,17,9,7,4,6,29,20
bicentenario-2010,Morelia,25,17,9,7,4,6,22,13
bicentenario-2010,Pachuca,25,17,1,7,4,6,27,26
bicentenario-2010,Club Querétaro,19,17,-2,4,7,6,22,24
bicentenario-2010,Puebla,19,17,-3,5,4,8,28,31
bicentenario-2010,Pumas,28,17,10,7,7,3,20,10
bicentenario-2010,Santos,28,17,2,8,4,5,27,25
bicentenario-2010,Cruz Azul,25,17,0,7,4,6,20,20
bicentenario-2010,Estudiantes,19,17,-6,5,4,8,26,32
bicentenario-2010,Tigres,19,17,-7,5,4,8,19,26
bicentenario-2010,Atlante,16,17,-8,4,4,9,21,29
apertura-2009,Toluca,35,17,13,11,2,4,32,19
apertura-2009,Chiapas FC,21,17,-3,5,6,6,21,24
apertura-2009,Chivas,19,17,-6,5,4,8,23,29
apertura-2009,Atlas,18,17,-11,5,3,9,14,25
apertura-2009,Gallos Blancos,18,17,-12,5,3,9,17,29
apertura-2009,Indios,6,17,-19,0,6,11,7,26
apertura-2009,Morelia,33,17,16,10,3,4,31,15
apertura-2009,América,30,17,13,8,6,3,29,16
apertura-2009,Monterrey,30,17,11,9,3,5,27,16
apertura-2009,Puebla,26,17,0,6,8,3,19,19
apertura-2009,Pachuca,24,17,-5,7,3,7,24,29
apertura-2009,Club Querétaro,19,17,-5,5,4,8,17,22
apertura-2009,Cruz Azul,33,17,16,11,0,6,35,19
apertura-2009,Santos,27,17,5,7,6,4,29,24
apertura-2009,Atlante,23,17,-5,7,2,8,18,23
apertura-2009,Tigres,22,17,5,5,7,5,23,18
apertura-2009,Estudiantes,20,17,-6,5,5,7,23,29
apertura-2009,Pumas,17,17,-7,4,5,8,16,23
clausura-2009,Pachuca,36,17,19,11,3,3,42,23
clausura-2009,Monterrey,26,17,6,7,5,5,28,22
clausura-2009,Puebla,26,17,-3,7,5,5,21,24
clausura-2009,Indios,23,17,-1,5,8,4,21,22
clausura-2009,Santos,22,17,5,5,7,5,25,20
clausura-2009,Atlante,17,17,-3,3,8,6,18,21
clausura-2009,Pumas,28,17,6,8,4,5,23,17
clausura-2009,Estudiantes,25,17,4,6,7,4,21,17
clausura-2009,América,23,17,-2,6,5,6,25,27
clausura-2009,Morelia,22,17,-1,5,7,5,19,20
clausura-2009,Chivas,21,17,1,5,6,6,21,20
clausura-2009,Cruz Azul,13,17,-7,2,7,8,26,33
clausura-2009,Toluca,36,17,15,10,6,1,34,19
clausura-2009,Club Querétaro,21,17,-2,5,6,6,22,24
clausura-2009,Atlas,21,17,-7,5,6,6,22,29
clausura-2009,Chiapas FC,17,17,-6,4,5,8,21,27
clausura-2009,Tigres,14,17,-11,2,8,7,15,26
clausura-2009,Necaxa,14,17,-13,3,5,9,17,30
apertura-2008,Atlante,27,17,6,7,6,4,22,16
apertura-2008,Santos,22,17,2,5,7,5,22,20
apertura-2008,Pachuca,21,17,0,5,6,6,25,25
apertura-2008,Indios,19,17,-8,5,4,8,18,26
apertura-2008,Monterrey,19,17,-8,5,4,8,18,26
apertura-2008,Puebla,15,17,-9,2,9,6,12,21
apertura-2008,Pumas,26,17,9,7,5,5,22,13
apertura-2008,Cruz Azul,26,17,6,7,5,5,29,23
apertura-2008,Estudiantes,25,17,2,7,4,6,30,28
apertura-2008,Chivas,25,17,0,6,7,4,23,23
apertura-2008,Morelia,24,17,7,6,6,5,27,20
apertura-2008,América,21,17,-1,5,6,6,22,23
apertura-2008,Chiapas FC,29,17,4,8,5,4,24,20
apertura-2008,Toluca,27,17,9,7,6,4,25,16
apertura-2008,Tigres,26,17,6,7,5,5,22,16
apertura-2008,Atlas,22,17,-4,6,4,7,23,27
apertura-2008,Club Querétaro,18,17,-14,5,3,9,20,34
apertura-2008,Necaxa,17,17,-7,3,8,6,17,24
clausura-2008,Toluca,27,17,4,7,6,4,23,19
clausura-2008,Club Querétaro,26,17,4,7,5,5,23,19
clausura-2008,Pachuca,22,17,2,6,4,7,27,25
clausura-2008,Puebla,21,17,3,5,6,6,28,25
clausura-2008,Pumas,20,17,-5,5,5,7,21,26
clausura-2008,Estudiantes,17,17,-12,4,5,8,17,29
clausura-2008,Santos,31,17,17,8,7,2,36,19
clausura-2008,Monterrey,24,17,5,6,6,5,27,22
clausura-2008,Atlas,23,17,-3,6,5,6,21,24
clausura-2008,Atlante,17,17,-6,3,8,6,24,30
clausura-2008,Veracruz,17,17,-7,4,5,8,22,29
clausura-2008,América,11,17,-15,3,2,12,12,27
clausura-2008,Chivas,33,17,18,9,6,2,32,14
clausura-2008,Cruz Azul,31,17,10,9,4,4,27,17
clausura-2008,Chiapas FC,30,17,2,8,6,3,25,23
clausura-2008,Necaxa,24,17,6,5,9,3,18,12
clausura-2008,Tigres,19,17,-9,5,4,8,19,28
clausura-2008,Morelia,18,17,-14,5,3,9,11,25
apertura-2007,Toluca,34,17,11,10,4,3,27,16
apertura-2007,Pumas,24,17,13,6,6,5,32,19
apertura-2007,Pachuca,24,17,3,7,3,7,26,23
apertura-2007,Club Querétaro,18,17,-6,3,9,5,22,28
apertura-2007,Puebla,17,17,-8,4,5,8,16,24
apertura-2007,Estudiantes,17,17,-14,5,2,10,24,38
apertura-2007,Santos,38,17,18,11,5,1,40,22
apertura-2007,Atlante,33,17,13,9,6,2,32,19
apertura-2007,América,26,17,4,7,5,5,26,22
apertura-2007,Veracruz,18,17,-15,5,3,9,20,35
apertura-2007,Monterrey,14,17,-7,3,5,9,18,25
apertura-2007,Atlas,12,17,-10,3,3,11,23,33
apertura-2007,Chivas,31,17,12,9,4,4,28,16
apertura-2007,Chiapas FC,29,17,1,8,5,4,31,30
apertura-2007,Cruz Azul,25,17,5,7,4,6,27,22
apertura-2007,Morelia,22,17,-5,6,4,7,20,25
apertura-2007,Necaxa,20,17,-9,5,5,7,23,32
apertura-2007,Tigres,16,17,-6,4,4,9,16,22
clausura-2007,Chivas,31,17,13,9,4,4,27,14
clausura-2007,Cruz Azul,28,17,5,8,4,5,22,17
clausura-2007,Atlas,25,17,3,7,4,6,20,17
clausura-2007,Gallos Blancos,19,17,-5,4,7,6,15,20
clausura-2007,Club Querétaro,19,17,-10,5,4,8,16,26
clausura-2007,Necaxa,18,17,-7,4,6,7,19,26
clausura-2007,Pachuca,39,17,24,12,3,2,36,12
clausura-2007,Estudiantes,25,17,7,6,7,4,30,23
clausura-2007,Chiapas FC,24,17,-2,7,3,7,21,23
clausura-2007,Atlante,21,17,-6,6,3,8,21,27
clausura-2007,Monterrey,19,17,-6,5,4,8,17,23
clausura-2007,Veracruz,12,17,-22,3,3,11,11,33
clausura-2007,América,30,17,11,9,3,5,26,15
clausura-2007,Tigres,23,17,-3,6,5,6,17,20
clausura-2007,Santos,22,17,1,6,4,7,21,20
clausura-2007,Morelia,22,17,-2,7,1,9,23,25
clausura-2007,Pumas,20,17,1,3,11,3,19,18
clausura-2007,Toluca,19,17,-2,3,10,4,15,17
apertura-2006,Cruz Azul,30,17,7,9,3,5,27,20
apertura-2006,Atlas,27,17,6,7,6,4,25,19
apertura-2006,Chivas,26,17,8,7,5,5,26,18
apertura-2006,Club Querétaro,23,17,3,6,5,6,19,16
apertura-2006,Gallos Blancos,21,17,-5,5,6,6,20,25
apertura-2006,Necaxa,17,17,-8,4,5,8,18,26
apertura-2006,Monterrey,27,17,6,7,6,4,27,21
apertura-2006,Pachuca,26,17,10,7,5,5,32,22
apertura-2006,Veracruz,26,17,-5,8,2,7,26,31
apertura-2006,Chiapas FC,23,17,2,6,5,6,14,12
apertura-2006,Atlante,23,17,-1,6,5,6,19,20
apertura-2006,Estudiantes,13,17,-13,3,4,10,22,35
apertura-2006,Pumas,29,17,10,8,5,4,21,11
apertura-2006,América,29,17,6,8,5,4,21,15
apertura-2006,Toluca,27,17,11,7,6,4,27,16
apertura-2006,Morelia,23,17,-2,7,2,8,24,26
apertura-2006,Tigres,14,17,-23,3,5,9,14,37
apertura-2006,Santos,11,17,-12,1,8,8,19,31
clausura-2006,Atlante,27,17,4,8,3,6,19,15
clausura-2006,Chiapas FC,25,17,4,7,4,6,23,19
clausura-2006,Morelia,22,17,-1,5,7,5,19,20
clausura-2006,Estudiantes,22,17,-11,6,4,7,18,29
clausura-2006,América,21,17,-3,6,3,8,20,23
clausura-2006,Necaxa,18,17,-9,5,3,9,19,28
clausura-2006,Pachuca,31,17,14,9,4,4,33,19
clausura-2006,Toluca,24,17,3,7,3,7,22,19
clausura-2006,Dorados,22,17,0,4,10,3,24,24
clausura-2006,Pumas,22,17,-1,5,7,5,15,16
clausura-2006,Veracruz,20,17,-3,5,5,7,16,19
clausura-2006,Santos,18,17,-5,3,9,5,20,25
clausura-2006,Club Querétaro,30,17,10,9,3,5,28,18
clausura-2006,Cruz Azul,30,17,9,9,3,5,29,20
clausura-2006,Chivas,23,17,-7,6,5,6,19,26
clausura-2006,Tigres,21,17,0,4,9,4,15,15
clausura-2006,Atlas,20,17,0,5,5,7,23,23
clausura-2006,Monterrey,18,17,-4,5,3,9,17,21
apertura-2005,América,38,17,12,12,2,3,34,22
apertura-2005,Necaxa,31,17,4,9,4,4,35,31
apertura-2005,Estudiantes,24,17,-1,7,3,7,27,28
apertura-2005,Morelia,20,17,-2,6,2,9,27,29
apertura-2005,Chiapas FC,16,17,-7,4,4,9,18,25
apertura-2005,Atlante,15,17,-8,4,3,10,29,37
apertura-2005,Toluca,30,17,6,9,3,5,27,21
apertura-2005,Pachuca,28,17,8,7,7,3,26,18
apertura-2005,Santos,20,17,0,5,5,7,31,31
apertura-2005,Dorados,18,17,-11,5,3,9,20,31
apertura-2005,Pumas,16,17,-17,4,4,9,17,34
apertura-2005,Veracruz,15,17,-10,3,6,8,24,34
apertura-2005,Monterrey,35,17,12,10,5,2,32,20
apertura-2005,Cruz Azul,30,17,14,9,3,5,34,20
apertura-2005,Club Querétaro,23,17,3,5,8,4,30,27
apertura-2005,Tigres,22,17,5,6,4,7,30,25
apertura-2005,Atlas,21,17,-2,6,3,8,22,24
apertura-2005,Chivas,19,17,-6,4,7,6,16,22
clausura-2005,Morelia,35,17,11,11,2,4,27,16
clausura-2005,América,30,17,11,7,9,1,38,27
clausura-2005,Estudiantes,29,17,10,8,5,4,31,21
clausura-2005,Dorados,26,17,4,7,5,5,23,19
clausura-2005,Atlante,20,17,3,5,5,7,24,21
clausura-2005,Pumas,14,17,-9,4,2,11,19,28
clausura-2005,Cruz Azul,31,17,17,9,4,4,36,19
clausura-2005,Tigres,24,17,6,6,6,5,25,19
clausura-2005,Chivas,23,17,-2,6,5,6,29,31
clausura-2005,Toluca,23,17,-5,6,5,6,17,22
clausura-2005,Puebla,16,17,-10,4,4,9,19,29
clausura-2005,Atlas,11,17,-14,2,5,10,21,35
clausura-2005,Necaxa,28,17,8,9,1,7,28,20
clausura-2005,Santos,28,17,0,9,1,7,31,31
clausura-2005,Monterrey,27,17,-1,8,3,6,24,25
clausura-2005,Club Querétaro,22,17,-4,6,4,7,19,23
clausura-2005,Pachuca,20,17,-7,5,5,7,20,27
clausura-2005,Veracruz,14,17,-18,3,5,9,15,33
apertura-2004,Atlante,24,17,-6,7,3,7,27,33
apertura-2004,Pumas,23,17,-6,7,2,8,25,31
apertura-2004,Morelia,22,17,-1,6,4,7,29,30
apertura-2004,América,20,17,-6,5,5,7,17,23
apertura-2004,Dorados,16,17,-7,4,4,9,25,32
apertura-2004,Estudiantes,16,17,-12,4,4,9,17,29
apertura-2004,Toluca,32,17,12,10,2,5,27,15
apertura-2004,Atlas,31,17,10,9,4,4,34,24
apertura-2004,Chivas,29,17,12,8,5,4,34,22
apertura-2004,Tigres,23,17,10,6,5,6,37,27
apertura-2004,Puebla,21,17,-6,5,6,6,17,23
apertura-2004,Cruz Azul,16,17,-7,4,4,9,30,37
apertura-2004,Veracruz,35,17,2,11,2,4,27,25
apertura-2004,Pachuca,32,17,11,9,5,3,30,19
apertura-2004,Monterrey,27,17,2,8,3,6,36,34
apertura-2004,Necaxa,21,17,1,6,3,8,27,26
apertura-2004,Santos,18,17,0,5,3,9,22,22
apertura-2004,Club Querétaro,18,17,-9,4,6,7,20,29
clausura-2004,Toluca,30,19,6,8,6,5,31,25
clausura-2004,Atlas,27,19,3,6,9,4,28,25
clausura-2004,Pachuca,26,19,-1,6,8,5,32,33
clausura-2004,Puebla,20,19,-2,5,5,9,27,29
clausura-2004,Monterrey,18,19,-2,2,12,5,28,30
clausura-2004,Pumas,41,19,23,12,5,2,42,19
clausura-2004,América,32,19,7,9,5,5,34,27
clausura-2004,Gallos Blancos,24,19,-3,5,9,5,24,27
clausura-2004,Santos,21,19,1,6,3,10,31,30
clausura-2004,Estudiantes,18,19,-8,5,3,11,32,40
clausura-2004,Club Querétaro,42,19,15,12,6,1,35,20
clausura-2004,Cruz Azul,23,19,2,6,5,8,36,34
clausura-2004,Tigres,23,19,-2,6,5,8,37,39
clausura-2004,Morelia,22,19,-10,6,4,9,25,35
clausura-2004,Chiapas FC,18,19,-12,4,6,9,23,35
clausura-2004,Chivas,34,19,7,10,4,5,30,23
clausura-2004,Atlante,27,19,3,7,6,6,29,26
clausura-2004,Irapuato,26,19,-7,6,8,5,23,30
clausura-2004,Necaxa,21,19,-4,5,6,8,22,26
clausura-2004,Veracruz,17,19,-16,4,5,10,25,41
apertura-2003,Pachuca,36,19,9,10,6,3,28,19
apertura-2003,Toluca,27,19,9,8,3,8,33,24
apertura-2003,Monterrey,22,19,0,5,7,7,29,29
apertura-2003,Puebla,20,19,-7,5,5,9,23,30
apertura-2003,Atlas,19,19,-3,5,4,10,29,32
apertura-2003,Pumas,38,19,11,11,5,3,34,23
apertura-2003,Santos,31,19,12,8,7,4,41,29
apertura-2003,Estudiantes,31,19,2,9,4,6,31,29
apertura-2003,América,28,19,8,8,4,7,34,26
apertura-2003,Gallos Blancos,7,19,-28,1,4,14,16,44
apertura-2003,Tigres,38,19,18,11,5,3,38,20
apertura-2003,Cruz Azul,27,19,0,7,6,6,30,30
apertura-2003,Morelia,25,19,-4,7,4,8,25,29
apertura-2003,Club Querétaro,21,19,-13,5,6,8,21,34
apertura-2003,Chiapas FC,11,19,-19,2,5,12,20,39
apertura-2003,Atlante,31,19,11,8,7,4,32,21
apertura-2003,Necaxa,30,19,5,7,9,3,23,18
apertura-2003,Chivas,29,19,2,9,2,8,30,28
apertura-2003,Veracruz,27,19,-4,8,3,8,34,38
apertura-2003,Irapuato,22,19,-9,6,4,9,23,32
clausura-2003,Toluca,33,19,10,10,3,6,40,30
clausura-2003,Atlas,32,19,9,8,8,3,29,20
clausura-2003,América,29,19,9,8,5,6,29,20
clausura-2003,Cuernavaca,23,19,-3,6,5,8,24,27
clausura-2003,Puebla,16,19,-16,4,4,11,15,31
clausura-2003,Monterrey,34,19,9,9,7,3,31,22
clausura-2003,Tigres,34,19,3,10,4,5,25,22
clausura-2003,Pachuca,21,19,-2,4,9,6,21,23
clausura-2003,Pumas,20,19,-10,4,8,7,25,35
clausura-2003,Estudiantes,7,19,-22,1,4,14,15,37
clausura-2003,Morelia,35,19,14,10,5,4,34,20
clausura-2003,Cruz Azul,24,19,0,5,9,5,24,24
clausura-2003,Necaxa,23,19,1,6,5,8,25,24
clausura-2003,Chiapas FC,20,19,-13,5,5,9,25,38
clausura-2003,Club Querétaro,19,19,-11,5,4,10,15,26
clausura-2003,Atlante,34,19,13,10,4,5,39,26
clausura-2003,Veracruz,32,19,5,9,5,5,23,18
clausura-2003,Chivas,31,19,8,8,7,4,32,24
clausura-2003,Santos,30,19,6,9,3,7,30,24
clausura-2003,Gallos Blancos,17,19,-10,3,8,8,13,23
apertura-2002,América,43,19,20,13,4,2,34,14
apertura-2002,Toluca,41,19,30,12,5,2,55,25
apertura-2002,Atlas,22,19,-3,7,1,11,28,31
apertura-2002,Puebla,22,19,-6,6,4,9,23,29
apertura-2002,Celaya,21,19,-8,5,6,8,24,32
apertura-2002,Pumas,33,19,4,10,3,6,39,35
apertura-2002,Estudiantes,29,19,-3,8,5,6,26,29
apertura-2002,Tigres,23,19,-1,6,5,8,32,33
apertura-2002,Monterrey,22,19,-2,5,7,7,18,20
apertura-2002,Pachuca,15,19,-14,2,9,8,21,35
apertura-2002,Morelia,32,19,12,9,5,5,35,23
apertura-2002,Cruz Azul,28,19,4,7,7,5,30,26
apertura-2002,Necaxa,26,19,-4,8,2,9,28,32
apertura-2002,Chiapas FC,24,19,3,6,6,7,31,28
apertura-2002,Club Querétaro,16,19,-15,3,7,9,19,34
apertura-2002,Chivas,27,19,-1,6,9,4,28,29
apertura-2002,Santos,26,19,2,7,5,7,30,28
apertura-2002,Atlante,25,19,-2,6,7,6,31,33
apertura-2002,Gallos Blancos,23,19,-6,6,5,8,28,34
apertura-2002,Veracruz,18,19,-10,4,6,9,30,40
verano-2002,Atlas,30,18,2,8,6,4,30,28
verano-2002,Cruz Azul,27,18,3,7,6,5,32,29
verano-2002,Chivas,22,18,1,5,7,6,22,21
verano-2002,Monterrey,20,18,-7,5,5,8,21,28
verano-2002,Celaya,20,18,-10,5,5,8,19,29
verano-2002,La Piedad,37,18,18,12,1,5,35,17
verano-2002,Toluca,35,18,18,10,5,3,35,17
verano-2002,Santos,31,18,11,9,4,5,42,31
verano-2002,Morelia,29,18,9,8,5,5,34,25
verano-2002,Veracruz,24,18,-8,7,3,8,22,30
verano-2002,Necaxa,27,18,11,7,6,5,34,23
verano-2002,América,27,18,4,7,6,5,27,23
verano-2002,Atlante,20,18,-6,5,5,8,23,29
verano-2002,Estudiantes,14,18,-9,2,8,8,25,34
verano-2002,León,10,18,-19,2,4,12,17,36
verano-2002,Pumas,32,18,8,9,5,4,30,22
verano-2002,Tigres,27,18,2,7,6,5,25,23
verano-2002,Pachuca,22,18,-7,6,4,8,26,33
verano-2002,Puebla,11,18,-21,2,5,11,24,45
invierno-2001,Cruz Azul,30,18,9,8,6,4,33,24
invierno-2001,Chivas,26,18,0,6,8,4,20,20
invierno-2001,Atlas,21,18,-4,6,3,9,25,29
invierno-2001,Monterrey,20,18,-8,4,8,6,23,31
invierno-2001,Celaya,19,18,-6,5,4,9,27,33
invierno-2001,Toluca,32,18,11,8,8,2,33,22
invierno-2001,Santos,24,18,2,7,3,8,36,34
invierno-2001,Morelia,20,18,-6,5,5,8,24,30
invierno-2001,Irapuato,19,18,1,4,7,7,27,26
invierno-2001,La Piedad,19,18,-12,4,7,7,28,40
invierno-2001,Necaxa,27,18,1,6,9,3,21,20
invierno-2001,Atlante,26,18,3,6,8,4,24,21
invierno-2001,América,24,18,0,6,6,6,21,21
invierno-2001,Estudiantes,19,18,-2,4,7,7,21,23
invierno-2001,León,19,18,-6,4,7,7,25,31
invierno-2001,Tigres,36,18,14,11,3,4,26,12
invierno-2001,Pachuca,32,18,5,9,5,4,29,24
invierno-2001,Puebla,23,18,0,5,8,5,22,22
invierno-2001,Pumas,17,18,-2,3,8,7,20,22
verano-2001,Atlante,23,17,0,6,5,6,16,16
verano-2001,León,23,17,-5,6,5,6,17,22
verano-2001,Morelia,23,17,-6,6,5,6,21,27
verano-2001,Cruz Azul,22,17,-2,6,4,7,25,27
verano-2001,Toluca,17,17,-5,3,8,6,28,33
verano-2001,Tigres,27,17,10,7,6,4,23,13
verano-2001,Atlas,22,17,-1,6,4,7,32,33
verano-2001,Pumas,22,17,-3,5,7,5,21,24
verano-2001,Celaya,18,17,-2,5,3,9,25,27
verano-2001,Irapuato,13,17,-11,3,4,10,27,38
verano-2001,Santos,28,17,8,8,4,5,35,27
verano-2001,Monterrey,28,17,7,7,7,3,25,18
verano-2001,Puebla,27,17,4,7,6,4,21,17
verano-2001,Necaxa,19,17,-5,5,4,8,20,25
verano-2001,América,28,17,10,7,7,3,25,15
verano-2001,Pachuca,25,17,0,7,4,6,22,22
verano-2001,Estudiantes,25,17,-3,7,4,6,24,27
verano-2001,Chivas,22,17,4,5,7,5,21,17
invierno-2000,Cruz Azul,33,17,13,10,3,4,34,21
invierno-2000,Toluca,30,17,6,9,3,5,32,26
invierno-2000,Morelia,27,17,5,7,6,4,29,24
invierno-2000,León,18,17,-6,4,6,7,27,33
invierno-2000,Atlante,17,17,-4,3,8,6,24,28
invierno-2000,Atlas,25,17,6,6,7,4,35,29
invierno-2000,Irapuato,25,17,2,6,7,4,28,26
invierno-2000,Tigres,24,17,0,6,6,5,23,23
invierno-2000,Pumas,19,17,-5,5,4,8,24,29
invierno-2000,Celaya,13,17,-6,3,4,10,21,27
invierno-2000,Necaxa,28,17,7,8,4,5,29,22
invierno-2000,Santos,26,17,3,7,5,5,32,29
invierno-2000,Monterrey,20,17,-7,5,5,7,23,30
invierno-2000,Puebla,16,17,-11,4,4,9,18,29
invierno-2000,Pachuca,28,17,6,8,4,5,24,18
invierno-2000,América,26,17,3,7,5,5,26,23
invierno-2000,Estudiantes,25,17,-3,7,4,6,33,36
invierno-2000,Chivas,14,17,-9,3,5,9,18,27
verano-2000,Toluca,40,17,16,13,1,3,44,28
verano-2000,Pumas,28,17,7,8,4,5,29,22
verano-2000,Toros Neza,20,17,-12,6,2,9,25,37
verano-2000,Estudiantes,19,17,-11,6,1,10,22,33
verano-2000,León,15,17,-7,3,6,8,23,30
verano-2000,Morelia,24,17,7,5,9,3,28,21
verano-2000,Puebla,24,17,2,6,6,5,30,28
verano-2000,Cruz Azul,21,17,5,6,3,8,38,33
verano-2000,Monterrey,21,17,-11,5,6,6,20,31
verano-2000,Celaya,19,17,-5,4,7,6,23,28
verano-2000,Santos,31,17,9,8,7,2,31,22
verano-2000,Atlas,26,17,3,7,5,5,32,29
verano-2000,América,23,17,5,6,5,6,36,31
verano-2000,Atlante,11,17,-18,2,5,10,16,34
verano-2000,Chivas,27,17,8,7,6,4,25,17
verano-2000,Necaxa,25,17,6,6,7,4,27,21
verano-2000,Tigres,22,17,3,5,7,5,25,22
verano-2000,Pachuca,17,17,-7,4,5,8,18,25
invierno-1999,Toluca,32,17,15,9,5,3,40,25
invierno-1999,Estudiantes,23,17,-9,7,2,8,26,35
invierno-1999,Pumas,21,17,-4,6,3,8,28,32
invierno-1999,León,18,17,-10,5,3,9,22,32
invierno-1999,Toros Neza,12,17,-22,3,3,11,19,41
invierno-1999,Cruz Azul,27,17,9,7,6,4,25,16
invierno-1999,Morelia,22,17,0,6,4,7,26,26
invierno-1999,Puebla,20,17,0,5,5,7,19,19
invierno-1999,Monterrey,20,17,-6,6,2,9,29,35
invierno-1999,Celaya,19,17,-8,5,4,8,19,27
invierno-1999,Atlas,38,17,24,11,5,1,40,16
invierno-1999,América,28,17,13,8,4,5,31,18
invierno-1999,Santos,20,17,-8,5,5,7,27,35
invierno-1999,Atlante,16,17,-9,3,7,7,20,29
invierno-1999,Necaxa,30,17,10,9,3,5,32,22
invierno-1999,Chivas,28,17,1,8,4,5,20,19
invierno-1999,Pachuca,26,17,0,8,2,7,28,28
invierno-1999,Tigres,22,17,4,5,7,5,27,23
verano-1999,Cruz Azul,31,17,6,9,4,4,30,24
verano-1999,Chivas,26,17,3,7,5,5,24,21
verano-1999,Celaya,24,17,3,6,6,5,29,26
verano-1999,León,16,17,-14,5,1,11,19,33
verano-1999,Puebla,13,17,-15,3,4,10,15,30
verano-1999,América,31,17,5,9,4,4,30,25
verano-1999,Morelia,25,17,0,8,1,8,23,23
verano-1999,Pachuca,24,17,1,6,6,5,23,22
verano-1999,Pumas,21,17,-8,6,3,8,19,27
verano-1999,Toros Neza,17,17,-8,4,5,8,21,29
verano-1999,Necaxa,22,17,5,5,7,5,30,25
verano-1999,Estudiantes,19,17,-7,6,1,10,21,28
verano-1999,Atlante,18,17,-3,4,6,7,31,34
verano-1999,Monterrey,14,17,-13,4,2,11,25,38
verano-1999,Toluca,39,17,27,12,3,2,50,23
verano-1999,Atlas,34,17,12,10,4,3,34,22
verano-1999,Santos,29,17,4,9,2,6,33,29
verano-1999,Tigres,23,17,2,7,2,8,34,32
invierno-1998,Cruz Azul,40,17,27,12,4,1,41,14
invierno-1998,Chivas,34,17,9,10,4,3,34,25
invierno-1998,Celaya,22,17,-1,6,4,7,28,29
invierno-1998,León,16,17,-9,4,4,9,25,34
invierno-1998,Puebla,9,17,-28,2,3,12,13,41
invierno-1998,Morelia,27,17,0,8,3,6,28,28
invierno-1998,Pumas,26,17,6,7,5,5,26,20
invierno-1998,América,22,17,-1,6,4,7,30,31
invierno-1998,Pachuca,16,17,-11,5,1,11,28,39
invierno-1998,Toros Neza,9,17,-18,2,3,12,18,36
invierno-1998,Necaxa,32,17,14,10,2,5,36,22
invierno-1998,Estudiantes,31,17,8,9,4,4,31,23
invierno-1998,Atlante,19,17,-8,5,4,8,22,30
invierno-1998,Monterrey,19,17,-10,4,7,6,20,30
invierno-1998,Toluca,36,17,25,10,6,1,39,14
invierno-1998,Atlas,26,17,6,8,2,7,34,28
invierno-1998,Tigres,22,17,2,5,7,5,30,28
invierno-1998,Santos,17,17,-11,4,5,8,22,33
verano-1998,Atlante,23,17,1,5,8,4,19,18
verano-1998,Puebla,18,17,-7,4,6,7,23,30
verano-1998,León,17,17,-12,4,5,8,20,32
verano-1998,Celaya,15,17,-10,3,6,8,13,23
verano-1998,Veracruz,14,17,-9,3,5,9,20,29
verano-1998,Toluca,33,17,14,10,3,4,39,25
verano-1998,Cruz Azul,30,17,14,8,6,3,32,18
verano-1998,Tigres,23,17,-7,7,2,8,15,22
verano-1998,Chivas,19,17,2,5,4,8,19,17
verano-1998,Monterrey,18,17,-5,4,6,7,20,25
verano-1998,Santos,26,17,2,8,2,7,24,22
verano-1998,Toros Neza,24,17,-3,7,3,7,21,24
verano-1998,Morelia,21,17,-4,5,6,6,26,30
verano-1998,Pumas,21,17,-5,6,3,8,23,28
verano-1998,Necaxa,32,17,16,10,2,5,34,18
verano-1998,Atlas,30,17,6,9,3,5,29,23
verano-1998,Estudiantes,30,17,2,9,3,5,23,21
verano-1998,América,26,17,5,7,5,5,27,22
invierno-1997,León,32,17,8,9,5,3,30,22
invierno-1997,Atlante,30,17,9,8,6,3,26,17
invierno-1997,Veracruz,21,17,-6,5,6,6,19,25
invierno-1997,Celaya,20,17,-5,5,5,7,21,26
invierno-1997,Puebla,19,17,-7,5,4,8,20,27
invierno-1997,Cruz Azul,31,17,13,8,7,2,29,16
invierno-1997,Chivas,29,17,4,8,5,4,28,24
invierno-1997,Monterrey,22,17,0,6,4,7,22,22
invierno-1997,Toluca,19,17,0,5,4,8,21,21
invierno-1997,Tigres,18,17,-6,5,3,9,20,26
invierno-1997,Morelia,28,17,6,7,7,3,25,19
invierno-1997,Toros Neza,23,17,0,6,5,6,29,29
invierno-1997,Pumas,16,17,-4,3,7,7,26,30
invierno-1997,Santos,16,17,-9,3,7,7,22,31
invierno-1997,América,29,17,8,8,5,4,27,19
invierno-1997,Atlas,23,17,2,6,5,6,28,26
invierno-1997,Necaxa,18,17,-5,4,6,7,26,31
invierno-1997,Estudiantes,16,17,-8,3,7,7,19,27
verano-1997,Toros Neza,30,17,8,9,3,5,40,32
verano-1997,Atlante,28,17,4,8,4,5,23,19
verano-1997,Cruz Azul,25,17,-3,7,4,6,21,24
verano-1997,Puebla,20,17,-3,4,8,5,15,18
verano-1997,Veracruz,10,17,-14,2,4,11,17,31
verano-1997,América,37,17,15,11,4,2,27,12
verano-1997,Necaxa,28,17,13,8,4,5,33,20
verano-1997,Morelia,25,17,3,6,7,4,26,23
verano-1997,León,23,17,3,5,8,4,21,18
verano-1997,Pachuca,17,17,-8,5,2,10,24,32
verano-1997,Chivas,34,17,11,9,7,1,27,16
verano-1997,Pumas,27,17,-1,8,3,6,25,26
verano-1997,Toluca,21,17,5,5,6,6,26,21
verano-1997,Atlas,16,17,-13,4,4,9,23,36
verano-1997,Santos,26,17,-1,8,2,7,27,28
verano-1997,Estudiantes,20,17,2,5,5,7,26,24
verano-1997,Monterrey,18,17,-13,5,3,9,25,38
verano-1997,Celaya,12,17,-8,2,6,9,20,28
invierno-1996,Atlante,38,17,19,12,2,3,30,11
invierno-1996,Puebla,31,17,10,9,4,4,32,22
invierno-1996,Toros Neza,24,17,-6,8,0,9,30,36
invierno-1996,Cruz Azul,20,17,0,5,5,7,26,26
invierno-1996,Veracruz,18,17,-7,4,6,7,14,21
invierno-1996,Necaxa,29,17,5,8,5,4,24,19
invierno-1996,León,23,17,5,5,8,4,24,19
invierno-1996,América,17,17,-3,4,5,8,24,27
invierno-1996,Pachuca,15,17,-11,3,6,8,25,36
invierno-1996,Morelia,12,17,-11,3,3,11,20,31
invierno-1996,Chivas,31,17,14,9,4,4,33,19
invierno-1996,Toluca,30,17,11,9,3,5,26,15
invierno-1996,Atlas,26,17,2,6,8,3,28,26
invierno-1996,Pumas,18,17,-4,4,6,7,23,27
invierno-1996,Santos,34,17,6,10,4,3,21,15
invierno-1996,Monterrey,19,17,-6,5,4,8,15,21
invierno-1996,Estudiantes,18,17,-10,5,3,9,20,30
invierno-1996,Celaya,17,17,-14,5,2,10,19,33
temporada-1995-1996,Veracruz,50,34,-1,15,5,14,44,45
temporada-1995-1996,Tigres,49,34,0,12,13,9,38,38
temporada-1995-1996,Chivas,43,34,-5,11,10,13,37,42
temporada-1995-1996,Santos,37,34,-2,9,10,15,41,43
temporada-1995-1996,Toluca,37,34,-12,10,7,17,33,45
temporada-1995-1996,Celaya,52,34,3,14,10,10,49,46
temporada-1995-1996,América,46,34,12,10,16,8,57,45
temporada-1995-1996,Morelia,36,34,-16,9,9,16,36,52
temporada-1995-1996,Atlante,33,34,-17,7,12,15,39,56
temporada-1995-1996,Puebla,28,34,-25,6,10,18,29,54
temporada-1995-1996,Cruz Azul,56,34,23,14,14,6,61,38
temporada-1995-1996,Monterrey,51,34,5,13,12,9,52,47
temporada-1995-1996,Pumas,50,34,9,13,11,10,50,41
temporada-1995-1996,León,50,34,6,13,11,10,55,49
temporada-1995-1996,Necaxa,55,34,17,15,10,9,58,41
temporada-1995-1996,Atlas,53,34,6,14,11,9,51,45
temporada-1995-1996,Toros Neza,50,34,3,13,11,10,53,50
temporada-1995-1996,Estudiantes,42,34,-6,8,18,8,41,47
temporada-1994-1995,América,70,36,42,19,13,4,88,46
temporada-1994-1995,Necaxa,60,36,30,15,15,6,68,38
temporada-1994-1995,Estudiantes,57,36,4,14,15,7,50,46
temporada-1994-1995,Toros Neza,44,36,-7,12,8,16,55,62
temporada-1994-1995,Tigres,30,36,-17,7,9,20,33,50
temporada-1994-1995,Cruz Azul,68,36,46,20,8,8,91,45
temporada-1994-1995,Veracruz,47,36,-8,12,11,13,43,51
temporada-1994-1995,Atlante,44,36,-12,11,11,14,57,69
temporada-1994-1995,Morelia,40,36,-19,9,13,14,55,74
temporada-1994-1995,Correcaminos,40,36,-21,10,10,16,42,63
temporada-1994-1995,Chivas,76,36,36,23,7,6,70,34
temporada-1994-1995,Pumas,56,36,12,15,11,10,49,37
temporada-1994-1995,Puebla,52,36,4,12,16,8,45,41
temporada-1994-1995,Toluca,36,36,-14,9,9,18,43,57
temporada-1994-1995,Tampico Madero,31,36,-32,8,7,21,41,73
temporada-1994-1995,Santos,45,36,-4,12,9,15,58,62
temporada-1994-1995,Atlas,44,36,-9,12,8,16,43,52
temporada-1994-1995,Monterrey,42,36,-15,9,15,12,37,52
temporada-1994-1995,León,42,36,-16,11,9,16,39,55
temporada-1993-1994,Santos,59,38,1,15,14,9,58,57
temporada-1993-1994,Necaxa,51,38,3,12,15,11,54,51
temporada-1993-1994,Puebla,43,38,-8,9,16,13,41,49
temporada-1993-1994,Leones Negros,38,38,-21,8,14,16,39,60
temporada-1993-1994,Tigres,37,38,-24,7,16,15,34,58
temporada-1993-1994,Atlante,61,38,19,19,4,15,78,59
temporada-1993-1994,Pumas,53,38,11,15,8,15,57,46
temporada-1993-1994,Morelia,53,38,-1,14,11,13,64,65
temporada-1993-1994,León,50,38,-5,13,11,14,45,50
temporada-1993-1994,Gallos Blancos,33,38,-21,6,15,17,38,59
temporada-1993-1994,Cruz Azul,66,38,29,18,12,8,62,33
temporada-1993-1994,Toluca,64,38,21,18,10,10,53,32
temporada-1993-1994,América,57,38,16,17,6,15,67,51
temporada-1993-1994,Veracruz,46,38,-15,12,10,16,50,65
temporada-1993-1994,Correcaminos,33,38,-17,6,15,17,36,53
temporada-1993-1994,Estudiantes,68,38,24,17,17,4,49,25
temporada-1993-1994,Atlas,59,38,15,16,11,11,55,40
temporada-1993-1994,Chivas,58,38,9,15,13,10,43,34
temporada-1993-1994,Monterrey,48,38,-15,12,12,14,56,71
temporada-1993-1994,Toros Neza,42,38,-21,10,12,16,46,67
temporada-1992--1993,Atlante,55,38,11,14,13,11,66,55
temporada-1992--1993,Veracruz,51,38,1,14,9,15,56,55
temporada-1992--1993,Gallos Blancos,37,38,-24,10,7,21,30,54
temporada-1992--1993,Santos,36,38,-25,7,15,16,33,58
temporada-1992--1993,Correcaminos,28,38,-29,5,13,20,25,54
temporada-1992--1993,Necaxa,77,38,33,23,8,7,76,43
temporada-1992--1993,América,65,38,5,18,11,9,51,46
temporada-1992--1993,Estudiantes,61,38,10,15,16,7,42,32
temporada-1992--1993,Puebla,57,38,1,15,12,11,58,57
temporada-1992--1993,Morelia,38,38,-18,8,14,16,43,61
temporada-1992--1993,Cruz Azul,61,38,24,17,10,11,69,45
temporada-1992--1993,Tigres,58,38,5,14,16,8,57,52
temporada-1992--1993,Atlas,49,38,-4,12,13,13,48,52
temporada-1992--1993,Chivas,44,38,-10,11,11,16,43,53
temporada-1992--1993,Leones Negros,38,38,-17,8,14,16,37,54
temporada-1992--1993,León,64,38,26,17,13,8,64,38
temporada-1992--1993,Pumas,61,38,16,17,10,11,69,53
temporada-1992--1993,Monterrey,60,38,12,15,15,8,51,39
temporada-1992--1993,Toluca,41,38,-1,9,14,15,49,50
temporada-1992--1993,Pachuca,38,38,-16,10,8,20,40,56
temporada-1991-1992,Pumas,59,38,12,15,14,9,53,41
temporada-1991-1992,Veracruz,56,38,9,16,8,14,52,43
temporada-1991-1992,Atlas,46,38,0,10,16,12,37,37
temporada-1991-1992,Estudiantes,36,38,-13,8,12,18,34,47
temporada-1991-1992,Cobras,29,38,-25,6,11,21,33,58
temporada-1991-1992,Chivas,58,38,10,13,19,6,41,31
temporada-1991-1992,Puebla,56,38,3,14,14,10,44,41
temporada-1991-1992,Correcaminos,53,38,4,14,11,13,46,42
temporada-1991-1992,Monterrey,48,38,-9,12,12,14,40,49
temporada-1991-1992,Gallos Blancos,39,38,-14,9,12,17,36,50
temporada-1991-1992,Necaxa,62,38,21,16,14,8,67,46
temporada-1991-1992,León,59,38,8,15,14,9,45,37
temporada-1991-1992,Cruz Azul,58,38,7,15,13,10,59,52
temporada-1991-1992,Toluca,51,38,-2,13,12,13,47,49
temporada-1991-1992,Santos,46,38,-9,12,10,16,42,51
temporada-1991-1992,Atlante,69,38,18,19,12,7,65,47
temporada-1991-1992,América,55,38,2,14,13,11,46,44
temporada-1991-1992,Tigres,52,38,1,14,10,14,52,51
temporada-1991-1992,Morelia,45,38,-6,10,15,13,41,47
temporada-1991-1992,Leones Negros,37,38,-17,9,10,19,42,59
temporada-1990-1991,América,58,38,8,15,13,10,59,51
temporada-1990-1991,Necaxa,47,38,-10,12,11,15,61,71
temporada-1990-1991,Morelia,45,38,-3,10,15,13,48,51
temporada-1990-1991,Estudiantes,43,38,-8,10,13,15,43,51
temporada-1990-1991,Santos,32,38,-18,6,14,18,35,53
temporada-1990-1991,Pumas,78,38,36,24,6,8,67,31
temporada-1990-1991,Cruz Azul,60,38,9,15,15,8,47,38
temporada-1990-1991,Veracruz,57,38,5,16,9,13,59,54
temporada-1990-1991,Toluca,50,38,3,12,14,12,53,50
temporada-1990-1991,Correcaminos,45,38,-11,10,15,13,35,46
temporada-1990-1991,Puebla,53,38,-3,14,11,13,40,43
temporada-1990-1991,Chivas,51,38,7,10,21,7,43,36
temporada-1990-1991,Tigres,48,38,-4,12,12,14,45,49
temporada-1990-1991,Gallos Blancos,38,38,-8,8,14,16,49,57
temporada-1990-1991,Irapuato,33,38,-34,7,12,19,38,72
temporada-1990-1991,Monterrey,64,38,19,18,10,10,60,41
temporada-1990-1991,Leones Negros,59,38,7,16,11,11,47,40
temporada-1990-1991,León,58,38,14,16,10,12,54,40
temporada-1990-1991,Atlas,55,38,6,15,10,13,38,32
temporada-1990-1991,Cobras,41,38,-15,9,14,15,36,51
temporada-1989-1990,Pumas,64,38,25,16,16,6,61,36
temporada-1989-1990,Puebla,63,38,15,17,12,9,57,42
temporada-1989-1990,Monterrey,56,38,7,14,14,10,54,47
temporada-1989-1990,Morelia,53,38,2,14,11,13,44,42
temporada-1989-1990,Irapuato,48,38,-3,10,18,10,37,40
temporada-1989-1990,Leones Negros,54,38,2,14,12,12,47,45
temporada-1989-1990,Toluca,50,38,10,11,17,10,42,32
temporada-1989-1990,Santos,43,38,-12,10,13,15,37,49
temporada-1989-1990,Cruz Azul,42,38,-14,8,18,12,47,61
temporada-1989-1990,Atlante,33,38,-19,7,12,19,27,46
temporada-1989-1990,América,64,38,25,16,16,6,70,45
temporada-1989-1990,Correcaminos,54,38,-2,14,12,12,34,36
temporada-1989-1990,Atlas,47,38,3,10,17,11,32,29
temporada-1989-1990,Estudiantes,43,38,-8,9,16,13,45,53
temporada-1989-1990,Tampico Madero,36,38,-20,8,12,18,28,48
temporada-1989-1990,Tigres,54,38,-2,14,12,12,62,64
temporada-1989-1990,Cobras,50,38,-5,12,14,12,43,48
temporada-1989-1990,Chivas,48,38,-1,10,18,10,41,42
temporada-1989-1990,Necaxa,47,38,0,10,17,11,36,36
temporada-1989-1990,Veracruz,46,38,-3,11,13,14,50,53
liguilla-1988-1989,Chivas,12,6,5,4,0,2,9,4
liguilla-1988-1989,América,11,6,6,3,2,1,12,6
liguilla-1988-1989,Estudiantes,6,6,-7,2,0,4,3,10
liguilla-1988-1989,Puebla,5,6,-4,1,2,3,5,9
liguilla-1988-1989,Cruz Azul,12,6,1,4,0,2,10,9
liguilla-1988-1989,Tampico Madero,10,6,0,3,1,2,9,9
liguilla-1988-1989,Pumas,8,6,5,2,2,2,12,7
liguilla-1988-1989,Atlante,3,6,-6,0,3,3,8,14
temporada-1988-1989,América,57,38,17,15,12,11,51,34
temporada-1988-1989,Cruz Azul,56,38,4,14,14,10,60,56
temporada-1988-1989,Toluca,41,38,-9,9,14,15,52,61
temporada-1988-1989,Monterrey,39,38,-12,6,21,11,36,48
temporada-1988-1989,Irapuato,39,38,-16,8,15,15,40,56
temporada-1988-1989,Puebla,69,38,36,18,15,5,66,30
temporada-1988-1989,Atlante,68,38,19,19,11,8,56,37
temporada-1988-1989,Leones Negros,57,38,-2,15,12,11,48,50
temporada-1988-1989,Tigres,41,38,-27,9,14,15,33,60
temporada-1988-1989,Santos,33,38,-27,5,18,15,21,48
temporada-1988-1989,Tampico Madero,69,38,34,20,9,9,85,51
temporada-1988-1989,Chivas,66,38,22,19,9,10,65,43
temporada-1988-1989,Necaxa,63,38,21,17,12,9,56,35
temporada-1988-1989,Morelia,50,38,4,11,17,10,57,53
temporada-1988-1989,Potosino,28,38,-33,5,13,20,27,60
temporada-1988-1989,Estudiantes,52,38,8,12,16,10,47,39
temporada-1988-1989,Pumas,50,38,8,11,17,10,36,28
temporada-1988-1989,Cobras,45,38,-9,8,21,9,36,45
temporada-1988-1989,Correcaminos,41,38,-13,9,14,15,44,57
temporada-1988-1989,Atlas,34,38,-25,8,10,20,41,66
temporada-1987-1988,Chivas,63,38,19,17,12,9,54,35
temporada-1987-1988,Pumas,60,38,27,15,15,8,82,55
temporada-1987-1988,Atlante,55,38,7,15,10,13,69,62
temporada-1987-1988,Tampico Madero,39,38,-12,7,18,13,50,62
temporada-1987-1988,Ángeles,39,38,-22,9,12,17,57,79
temporada-1987-1988,Leones Negros,70,38,28,20,10,8,77,49
temporada-1987-1988,Estudiantes,64,38,18,18,10,10,59,41
temporada-1987-1988,Cruz Azul,54,38,2,14,12,12,58,56
temporada-1987-1988,Atlas,44,38,-11,11,11,16,62,73
temporada-1987-1988,Potosino,36,38,-21,7,15,16,34,55
temporada-1987-1988,América,79,38,47,24,7,7,86,39
temporada-1987-1988,Puebla,51,38,7,13,12,13,58,51
temporada-1987-1988,Necaxa,49,38,-15,12,13,13,49,64
temporada-1987-1988,Toros Neza,47,38,-14,12,11,15,46,60
temporada-1987-1988,Irapuato,43,38,-27,12,7,19,40,67
temporada-1987-1988,Morelia,55,38,15,14,13,11,58,43
temporada-1987-1988,Toluca,55,38,-1,16,7,15,49,50
temporada-1987-1988,Tigres,44,38,-14,12,8,18,51,65
temporada-1987-1988,Monterrey,40,38,-10,9,13,16,55,65
temporada-1987-1988,Correcaminos,40,38,-23,10,10,18,39,62
temporada-1986-1987,Monterrey,51,40,-8,14,9,17,44,52
temporada-1986-1987,Toluca,47,40,0,7,26,7,35,35
temporada-1986-1987,Estudiantes,45,40,0,7,24,9,37,37
temporada-1986-1987,Necaxa,45,40,-8,7,24,9,28,36
temporada-1986-1987,Atlante,42,40,-5,8,18,14,29,34
temporada-1986-1987,Chivas,74,40,31,20,14,6,58,27
temporada-1986-1987,Tampico Madero,55,40,1,14,13,13,55,54
temporada-1986-1987,Toros Neza,52,40,-3,13,13,14,35,38
temporada-1986-1987,Tigres,50,40,3,8,26,6,40,37
temporada-1986-1987,León,42,40,-16,10,12,18,36,52
temporada-1986-1987,Morelia,65,40,7,17,14,9,47,40
temporada-1986-1987,Puebla,56,40,10,14,14,12,56,46
temporada-1986-1987,Pumas,50,40,1,11,17,12,33,32
temporada-1986-1987,Leones Negros,48,40,-1,10,18,12,43,44
temporada-1986-1987,Atlas,43,40,-9,9,16,15,35,44
temporada-1986-1987,América,66,40,24,16,18,6,55,31
temporada-1986-1987,Cruz Azul,65,40,13,15,20,5,44,31
temporada-1986-1987,Potosino,48,40,-10,9,21,10,29,39
temporada-1986-1987,Irapuato,45,40,-5,8,21,11,39,44
temporada-1986-1987,Ángeles,44,40,-6,9,17,14,35,41
temporada-1986-1987,Cobras,39,40,-19,6,21,13,22,41
temporada-1984-1985,América,64,38,14,17,13,8,50,36
temporada-1984-1985,León,52,38,8,11,19,8,53,45
temporada-1984-1985,Tigres,48,38,-5,13,9,16,40,45
temporada-1984-1985,Toros Neza,36,38,-14,8,12,18,42,56
temporada-1984-1985,Necaxa,30,38,-22,5,15,18,35,57
temporada-1984-1985,Pumas,76,38,32,23,7,8,68,36
temporada-1984-1985,Tampico Madero,60,38,8,17,9,12,64,56
temporada-1984-1985,Atlas,57,38,4,15,12,11,50,46
temporada-1984-1985,Oaxtepec,45,38,-11,11,12,15,50,61
temporada-1984-1985,Morelia,36,38,-18,6,18,14,37,55
temporada-1984-1985,Leones Negros,66,38,18,17,15,6,56,38
temporada-1984-1985,Cruz Azul,62,38,15,16,14,8,49,34
temporada-1984-1985,Atlante,61,38,9,16,13,9,49,40
temporada-1984-1985,Monterrey,44,38,-14,10,14,14,48,62
temporada-1984-1985,Potosino,38,38,-14,6,20,12,35,49
temporada-1984-1985,Chivas,62,38,20,16,14,8,48,28
temporada-1984-1985,Puebla,50,38,8,13,11,14,52,44
temporada-1984-1985,Estudiantes,46,38,0,11,13,14,48,48
temporada-1984-1985,Toluca,39,38,-15,8,15,15,31,46
temporada-1984-1985,Zacatepec,37,38,-23,10,7,21,30,53
temporada-1983-1984,América,65,38,20,16,17,5,46,26
temporada-1983-1984,Monterrey,50,38,6,12,14,12,51,45
temporada-1983-1984,Atlas,43,38,-17,9,16,13,51,68
temporada-1983-1984,Necaxa,42,38,-9,9,15,14,54,63
temporada-1983-1984,Potosino,37,38,-27,8,13,17,28,55
temporada-1983-1984,Atlante,63,38,18,16,15,7,56,38
temporada-1983-1984,Chivas,57,38,14,13,18,7,53,39
temporada-1983-1984,Toluca,50,38,-3,13,11,14,53,56
temporada-1983-1984,Toros Neza,38,38,-2,1,35,2,12,14
temporada-1983-1984,Curtidores,29,38,-23,6,11,21,33,56
temporada-1983-1984,Pumas,64,38,25,16,16,6,62,37
temporada-1983-1984,Estudiantes,59,38,16,14,17,7,53,37
temporada-1983-1984,Morelia,54,38,9,14,12,12,58,49
temporada-1983-1984,Tampico Madero,51,38,-3,12,15,11,53,56
temporada-1983-1984,Puebla,47,38,0,11,14,13,48,48
temporada-1983-1984,Tigres,53,38,-3,13,14,11,48,51
temporada-1983-1984,Cruz Azul,52,38,7,12,16,10,39,32
temporada-1983-1984,León,46,38,-1,11,13,14,48,49
temporada-1983-1984,Leones Negros,44,38,-8,9,17,12,42,50
temporada-1983-1984,Oaxtepec,39,38,-19,8,15,15,36,55
temporada-1982-1983,Potosino,47,38,-4,10,17,11,35,39
temporada-1982-1983,Atlas,45,38,-11,8,21,9,31,42
temporada-1982-1983,Atlante,42,38,5,3,33,2,16,11
temporada-1982-1983,Necaxa,40,38,-8,7,19,12,42,50
temporada-1982-1983,Monterrey,36,38,-17,6,18,14,24,41
temporada-1982-1983,América,71,38,30,18,17,3,54,24
temporada-1982-1983,Chivas,49,38,1,10,19,9,30,29
temporada-1982-1983,León,48,38,5,7,27,4,33,28
temporada-1982-1983,Tampico Madero,45,38,-11,10,15,13,38,49
temporada-1982-1983,Toros Neza,41,38,-5,7,20,11,32,37
temporada-1982-1983,Toluca,53,38,16,11,20,7,40,24
temporada-1982-1983,Estudiantes,53,38,4,12,17,9,40,36
temporada-1982-1983,Cruz Azul,45,38,2,9,18,11,35,33
temporada-1982-1983,Oaxtepec,42,38,-1,5,27,6,18,19
temporada-1982-1983,Zacatepec,38,38,0,0,38,0,2,2
temporada-1982-1983,Puebla,53,38,10,11,20,7,39,29
temporada-1982-1983,Pumas,52,38,12,12,16,10,47,35
temporada-1982-1983,Leones Negros,48,38,-4,9,21,8,32,36
temporada-1982-1983,Morelia,41,38,-9,6,23,9,15,24
temporada-1982-1983,Tigres,40,38,-15,8,16,14,31,46
temporada-1981-1982,América,56,38,18,13,17,8,44,26
temporada-1981-1982,Tigres,54,38,11,12,18,8,44,33
temporada-1981-1982,Puebla,54,38,3,13,15,10,52,49
temporada-1981-1982,Pumas,47,38,8,10,17,11,52,44
temporada-1981-1982,Atlas,37,38,-28,9,10,19,31,59
temporada-1981-1982,Cruz Azul,56,38,5,13,17,8,47,42
temporada-1981-1982,Toros Neza,54,38,9,11,21,6,46,37
temporada-1981-1982,Potosino,52,38,0,11,19,8,44,44
temporada-1981-1982,Leones Negros,47,38,7,8,23,7,31,24
temporada-1981-1982,León,33,38,-19,5,18,15,33,52
temporada-1981-1982,Zacatepec,57,38,12,13,18,7,38,26
temporada-1981-1982,Atlético Español,45,38,-5,10,15,13,43,48
temporada-1981-1982,Tampico Madero,43,38,3,5,28,5,26,23
temporada-1981-1982,Morelia,42,38,-1,4,30,4,9,10
temporada-1981-1982,Chivas,32,38,-17,4,20,14,28,45
temporada-1981-1982,Atlante,64,38,20,16,16,6,48,28
temporada-1981-1982,Campesinos,47,38,1,10,17,11,37,36
temporada-1981-1982,Monterrey,46,38,-9,8,22,8,32,41
temporada-1981-1982,Toluca,43,38,-8,8,19,11,41,49
temporada-1981-1982,Estudiantes,43,38,-10,9,16,13,39,49
liguilla-1980-1981,Cruz Azul,11,6,2,3,2,1,5,3
liguilla-1980-1981,Zacatepec,10,6,5,3,1,2,12,7
liguilla-1980-1981,Toluca,7,6,-2,2,1,3,5,7
liguilla-1980-1981,Estudiantes,5,6,-5,1,2,3,6,11
liguilla-1980-1981,Pumas,13,6,3,4,1,1,12,9
liguilla-1980-1981,Toros Neza,8,6,1,2,2,2,4,3
liguilla-1980-1981,Chivas,7,6,-2,2,1,3,7,9
liguilla-1980-1981,Atlético Español,5,6,-2,1,2,3,6,8
temporada-1980-1981,Atlético Español,60,38,3,15,15,8,39,36
temporada-1980-1981,Toluca,51,38,2,12,15,11,36,34
temporada-1980-1981,América,49,38,7,11,16,11,48,41
temporada-1980-1981,Monterrey,42,38,-1,5,27,6,29,30
temporada-1980-1981,Atlas,32,38,-21,6,14,18,26,47
temporada-1980-1981,Cruz Azul,57,38,11,13,18,7,43,32
temporada-1980-1981,Toros Neza,54,38,4,12,18,8,37,33
temporada-1980-1981,Leones Negros,43,38,-10,10,13,15,40,50
temporada-1980-1981,Puebla,40,38,-8,5,25,8,28,36
temporada-1980-1981,León,36,38,-29,5,21,12,26,55
temporada-1980-1981,Estudiantes,68,38,23,17,17,4,58,35
temporada-1980-1981,Zacatepec,55,38,10,15,10,13,63,53
temporada-1980-1981,Atlante,49,38,6,12,13,13,46,40
temporada-1980-1981,Potosino,49,38,-2,9,22,7,42,44
temporada-1980-1981,Curtidores,39,38,-13,7,18,13,25,38
temporada-1980-1981,Pumas,66,38,29,17,15,6,71,42
temporada-1980-1981,Campesinos,47,38,3,9,20,9,27,24
temporada-1980-1981,Chivas,45,38,1,6,27,5,17,16
temporada-1980-1981,Tigres,41,38,-9,9,14,15,37,46
temporada-1980-1981,Tampico Madero,40,38,-6,8,16,14,39,45
liguilla-1979-1980,Tigres,9,6,3,2,3,1,9,6
liguilla-1979-1980,América,8,6,1,2,2,2,6,5
liguilla-1979-1980,Pumas,7,6,0,1,4,1,3,3
liguilla-1979-1980,Zacatepec,6,6,-4,1,3,2,5,9
liguilla-1979-1980,Cruz Azul,12,6,2,4,0,2,8,6
liguilla-1979-1980,Atlante,8,6,2,2,2,2,12,10
liguilla-1979-1980,Toros Neza,8,6,0,2,2,2,5,5
liguilla-1979-1980,Tampico Madero,5,6,-4,1,2,3,6,10
temporada-1979-1980,Cruz Azul,71,38,29,18,17,3,61,32
temporada-1979-1980,Atlante,63,38,27,16,15,7,59,32
temporada-1979-1980,Monterrey,43,38,-5,7,22,9,30,35
temporada-1979-1980,Jalisco,41,38,-5,8,17,13,42,47
temporada-1979-1980,Puebla,40,38,-10,9,13,16,47,57
temporada-1979-1980,Pumas,63,38,13,17,12,9,62,49
temporada-1979-1980,Tampico Madero,57,38,12,14,15,9,55,43
temporada-1979-1980,Chivas,39,38,-1,4,27,7,20,21
temporada-1979-1980,Curtidores,38,38,-12,9,11,18,30,42
temporada-1979-1980,Potosino,38,38,-15,7,17,14,29,44
temporada-1979-1980,América,78,38,32,22,12,4,68,36
temporada-1979-1980,Toros Neza,55,38,15,11,22,5,52,37
temporada-1979-1980,Toluca,46,38,-5,10,16,12,36,41
temporada-1979-1980,Leones Negros,41,38,-13,9,14,15,40,53
temporada-1979-1980,León,38,38,-17,8,14,16,35,52
temporada-1979-1980,Tigres,55,38,1,14,13,11,56,55
temporada-1979-1980,Zacatepec,50,38,6,8,26,4,33,27
temporada-1979-1980,Estudiantes,44,38,-12,9,17,12,45,57
temporada-1979-1980,Atlas,39,38,-21,8,15,15,37,58
temporada-1979-1980,Atlético Español,38,38,-19,9,11,18,34,53
liguilla-1978-1979,Cruz Azul,13,6,3,4,1,1,8,5
liguilla-1978-1979,Toluca,9,6,4,3,0,3,9,5
liguilla-1978-1979,América,9,6,1,3,0,3,7,6
liguilla-1978-1979,Potosino,4,6,-8,1,1,4,5,13
liguilla-1978-1979,Pumas,11,6,3,3,2,1,9,6
liguilla-1978-1979,Tigres,11,6,1,3,2,1,7,6
liguilla-1978-1979,Monterrey,7,6,0,1,4,1,8,8
liguilla-1978-1979,Zacatepec,2,6,-4,0,2,4,6,10
temporada-1978-1979,Monterrey,49,38,5,10,19,9,40,35
temporada-1978-1979,América,43,38,3,8,19,11,37,34
temporada-1978-1979,Chivas,43,38,-13,9,16,13,33,46
temporada-1978-1979,Atlante,39,38,-2,3,30,5,16,18
temporada-1978-1979,Veracruz,36,38,-30,5,21,12,21,51
temporada-1978-1979,Potosino,61,38,6,16,13,9,47,41
temporada-1978-1979,Pumas,60,38,19,16,12,10,69,50
temporada-1978-1979,León,51,38,-4,11,18,9,39,43
temporada-1978-1979,Tampico Madero,50,38,1,11,17,10,53,52
temporada-1978-1979,Jalisco,39,38,-9,5,24,9,25,34
temporada-1978-1979,Cruz Azul,61,38,32,14,19,5,57,25
temporada-1978-1979,Toluca,60,38,12,16,12,10,45,33
temporada-1978-1979,Puebla,50,38,2,11,17,10,46,44
temporada-1978-1979,Curtidores,44,38,-4,10,14,14,48,52
temporada-1978-1979,Leones Negros,37,38,-9,6,19,13,38,47
temporada-1978-1979,Tigres,60,38,9,14,18,6,48,39
temporada-1978-1979,Atlético Español,49,38,-9,11,16,11,45,54
temporada-1978-1979,Zacatepec,45,38,6,4,33,1,18,12
temporada-1978-1979,Estudiantes,42,38,4,6,24,8,34,30
temporada-1978-1979,Toros Neza,31,38,-19,4,19,15,16,35
temporada-1977-1978,Estudiantes,58,38,25,12,22,4,55,30
temporada-1977-1978,Pumas,47,38,7,7,26,5,34,27
temporada-1977-1978,Santos Laguna,44,38,1,4,32,2,18,17
temporada-1977-1978,Potosino,34,38,-21,4,22,12,21,42
temporada-1977-1978,Curtidores,33,38,-20,3,24,11,18,38
temporada-1977-1978,América,59,38,8,13,20,5,34,26
temporada-1977-1978,Tigres,52,38,5,11,19,8,26,21
temporada-1977-1978,León,49,38,4,9,22,7,39,35
temporada-1977-1978,Monterrey,48,38,6,8,24,6,32,26
temporada-1977-1978,Jalisco,44,38,1,5,29,4,19,18
temporada-1977-1978,Tampico Madero,49,38,4,9,22,7,38,34
temporada-1977-1978,Cruz Azul,47,38,5,7,26,5,32,27
temporada-1977-1978,Veracruz,42,38,1,5,27,6,22,21
temporada-1977-1978,Chivas,35,38,-10,4,23,11,24,34
temporada-1977-1978,Atlante,34,38,-13,3,25,10,19,32
temporada-1977-1978,Toluca,52,38,11,9,25,4,25,14
temporada-1977-1978,Leones Negros,52,38,9,11,19,8,42,33
temporada-1977-1978,Atlético Español,48,38,7,8,24,6,41,34
temporada-1977-1978,Puebla,39,38,-10,6,21,11,17,27
temporada-1977-1978,Atlas,37,38,-20,5,22,11,17,37
liguilla-1976-1977,Pumas,11,6,2,3,2,1,8,6
liguilla-1976-1977,Cruz Azul,10,6,2,3,1,2,6,4
liguilla-1976-1977,Chiapas FC,7,6,1,2,1,3,7,6
liguilla-1976-1977,Atlético Español,5,6,-5,1,2,3,3,8
liguilla-1976-1977,América,11,6,8,3,2,1,14,6
liguilla-1976-1977,Leones Negros,11,6,5,3,2,1,8,3
liguilla-1976-1977,Potosino,7,6,-5,2,1,3,9,14
liguilla-1976-1977,Chivas,4,6,-8,1,1,4,2,10
temporada-1976-1977,América,64,38,16,15,19,4,51,35
temporada-1976-1977,Puebla,51,38,3,13,12,13,49,46
temporada-1976-1977,León,51,38,2,12,15,11,45,43
temporada-1976-1977,Chivas,51,38,1,11,18,9,35,34
temporada-1976-1977,Veracruz,41,38,-14,9,14,15,40,54
temporada-1976-1977,Pumas,65,38,18,17,14,7,58,40
temporada-1976-1977,Potosino,52,38,6,12,16,10,44,38
temporada-1976-1977,Estudiantes,45,38,-1,7,24,7,22,23
temporada-1976-1977,Monterrey,40,38,-8,8,16,14,40,48
temporada-1976-1977,Zacatepec,34,38,-14,3,25,10,15,29
temporada-1976-1977,Cruz Azul,60,38,11,15,15,8,46,35
temporada-1976-1977,Chiapas FC,50,38,0,10,20,8,40,40
temporada-1976-1977,Toluca,45,38,-4,10,15,13,37,41
temporada-1976-1977,Atlas,43,38,-8,9,16,13,46,54
temporada-1976-1977,Tigres,36,38,-15,6,18,14,32,47
temporada-1976-1977,Atlético Español,59,38,18,14,17,7,40,22
temporada-1976-1977,Leones Negros,55,38,7,13,16,9,41,34
temporada-1976-1977,Jalisco,45,38,3,9,18,11,58,55
temporada-1976-1977,Santos,44,38,-13,8,20,10,30,43
temporada-1976-1977,Curtidores,38,38,-8,8,14,16,41,49
temporada-1975-1976,América,73,38,17,21,10,7,55,38
temporada-1975-1976,Estudiantes,48,38,-6,9,21,8,25,31
temporada-1975-1976,Chivas,43,38,-10,9,16,13,34,44
temporada-1975-1976,Puebla,38,38,-16,8,14,16,38,54
temporada-1975-1976,Potosino,31,38,-30,7,10,21,35,65
temporada-1975-1976,Monterrey,60,38,12,15,15,8,43,31
temporada-1975-1976,Atlas,50,38,3,12,14,12,51,48
temporada-1975-1976,Curtidores,47,38,2,8,23,7,41,39
temporada-1975-1976,Tigres,43,38,-5,7,22,9,31,36
temporada-1975-1976,Atlante,33,38,-18,3,24,11,18,36
temporada-1975-1976,Leones Negros,58,38,15,15,13,10,48,33
temporada-1975-1976,Cruz Azul,57,38,21,14,15,9,51,30
temporada-1975-1976,Veracruz,44,38,-22,10,14,14,35,57
temporada-1975-1976,Atlético Español,42,38,3,5,27,6,28,25
temporada-1975-1976,Zacatepec,37,38,-18,8,13,17,35,53
temporada-1975-1976,Pumas,61,38,21,15,16,7,56,35
temporada-1975-1976,León,61,38,17,15,16,7,49,32
temporada-1975-1976,Toluca,54,38,8,13,15,10,44,36
temporada-1975-1976,Laguna,51,38,7,11,18,9,44,37
temporada-1975-1976,Jalisco,44,38,-1,10,14,14,58,59
